1111111111111111
10C000C00CE000P1
1111111111111111
