1111111111111111
1000000000001001
10000E0000001001
1000001000001001
10C000100C0000P1
1111111111111111
