1111111111111111
10C000C00C1000A1
10C000C0001000A1
111C00C00010A001
101E00C000P00001
1111111111111111
