1111111111111111
100000A000001001
100000A000001001
1000000000001001
1EC000C00C0000P1
1111111111111111
