1111111111111111
10000A00000010E1
1000000011001001
1110000101001001
1A1000C1110000P1
1111111111111111
