11111111111111111111111111111111111111
10000000000000000000000000000000000C01
10E00000000001111111011111111111111101
100000000011111111C0011110001111111101
1000000011111110C00001010C001111111101
1000011111111C000000010000001111111C01
1001111111C00000000P000000111111110001
10011111C00000000000000111111100000001
100111CCCCCCC0CCCCCC011111110000000001
10011111111111111111011111110000000001
10011111111111111111011111110000000001
10011111111111111111011111000000000001
100C0000000001111111011000000000000001
10000000000C011111110110000C0000000001
10000000000C01111111011111111111110001
1CC000CCCC0C00000000011111111111110011
11111111111111111111111111111111111111