11111111111111111111111111111111111111
10000000000000000000000000000000000001
10E00000000001111111111111111111111101
100000000011111111C0011110001111111101
1000000011111110C00001010C001111111101
10000111AAA11C000000010000001111111C01
1001111111C00000000P000000111111110001
10011111C00000000000000111111100000001
100111CCCCCCC0CCCCCC011111110000000001
10011111111111111111011111110000011101
10011111111111111111011111110001111101
10011111111111111111011101110111111101
100C0000000001111111000000000000000001
10000000000C011111110110000C0000000001
1000AAAA000C01111111011111111111110001
1CC000CCCC0C01111110000000C00000000011
11111111111111111111111111111111111111